AERG : Association des Etudiants Rescapés du Génocide
BNR : Banque Nationale du Rwanda
CNF : Conseil National des Femmes
CNJ : Conseil National de la Jeunesse
CNLG : Commission Nationale de Lutte contre le Genocide
COOJAD : Coopérative de la Jeunesse pour l’Auto-emploi et le Développement
Ex-CSR : Ex-Caisse Sociale du Rwanda
DRC : Democratic Republic of Congo
ETO : Ecole Technique Officielle
FARG : Fonds National pour l’Assistance aux Rescapés du Génocide
Ha : Hectare
ICT : Information and Communication Technology
IFAK : Institut de Formation Apostolique de Kimihurura
INILAK : Institut Independant Laïque de Kigali
IPRC : Integrated Polytechinic Regional Centers
MDAs : Ministries and Delivery Agencies
MIDIMAR : Ministry of Disaster Management and Refugee Affairs
MIFOTRA : Ministry of Public Service and Labour
MIJESPOC : Ministry of Youth Sports and Culture
MINAFFET : Ministry Of Foreign Affairs and Cooperation
MINECOFIN : Ministry of Finance and Economic Planning
MINICOM : Ministry of Trade and Industry
MININFRA : Ministry of Infrastructure
MINIJUST : Ministry of Justice
MINIPRESIREP : Minitère à la Présidence de la Republique
NAEB : National Agricultural Export Board
NGOs : Non-Governmental Organisations
PMTCT : Prevention of Mother- to-Child Transimisom
PTAs : Parents and Teachers’ Associations
RCA : Rwanda Cooperative Agency
RDB : Rwanda Development Board
RSSB : Rwanda Social Security Board
SACCO : Savings and Credit Cooperatives
SIDA : Syndrome d’ Immunodéficience Acquise
SMS : Short Message Service
TOT : Training Of Trainers
VTC : Vocational Training Centre
TVET : Technical and Vocational Education Training
TV : Television
UN : United Nations
UNHCR : United Nations High Commission for Refugees
USA : United State of America
VVOB : Vlaamse Verenigning voor Ontwikkelingssam en werking en Technische Bijstand (a Flemish Association for Development)
WDA : Worforce Development Authority
